NO textures/matrix.xpm

SO textures/matrix.xpm


WE textures/matrix.xpm

EA textures/matrix.xpm



 F 255,0,0
C 0,0,255





111111
10011
1N0011111
111111
1111111
11111111
100001
1111111
11111



 
  

   
    
     
     

      

       









