NO textures/wolfenstein/grey_stone.xpm
SO textures/wolfenstein/purple_stone.xpm
WE textures/wolfenstein/red_brick.xpm
EA textures/wolfenstein/wood.xpm



 F 255,0,0

C 0,0,255


 
  
   
    
     
      
      11111
        1N1
111111111111111
 
  

   
    
     
      
       
       























