NO textures/wolfenstein/grey_stone.xpm 
SO textures/wolfenstein/purple_stone.xpm
WE textures/wolfenstein/red_brick.xpm
                F          255                   ,0,                                     21

EA textures/wolfenstein/wood.xpm




                               C            0,          0   ,       255



 
  
   
    
     
      
      1111
11111111101111111111
        1N1
11111111111111
 
  

   
    
     
      
       
       























