NO textures/egypt/egypt_wall_north.xpm
WE textures/egypt/egypt_wall_east.xpm
SO textures/egypt/egypt_wall_north.xpm
EA textures/egypt/egypt_wall_east.xpm

F 179,144,96
C 159,228,245

        1111111111111111111111111111111
        1001000000110000000000000000001
        1001000000100000000000000000001
        1001000000100000000000000000001
        1001000000100000000000000000001
111111111011000000110000000000000000001
100000000011000001111111111111111111111
11100011111111111100000010000000001
11111111111110001101010010000000001
11000000110100000100000010000000001
10000000000000000100000010000000001
10000000000000000101010010000000001
11000001110101011111011110000N0000111
11110111 1110101 101111010000000001
11111111 1111111 111111111111111111
