 
 

 C 35,19,73
F 15,6,7

 NO test1.xpm

SO test2.xpm


WE test3.xpm

EA tes4.xpm

111 11
10011
1N101
1001
10001
100011111
 111010001
1000111111
10001
10001
10001
10001
11111

  




  
   

    