


 C 35,19,73
F 15,6,7

 NO test1.xpm

SO test2.xpm


WE test3.xpm

EA tes4.xpm

111111
10011
10101
1001
1001
1W0011111
 11010001
10111111
10001
10001
10001
10001
11111









